{
    "x": 16,
    "y": 12,
    "data": [
        1, 1, 1, 1, 1, 1, 1, 1, 1, 1, 1, 1, 1, 1, 1, 1,
        1, 7, 0, 0, 0, 0, 0, 0, 0, 0, 0, 0, 0, 0, 8, 1,
        1, 0, 0, 5, 1, 1, 2, 0, 0, 5, 1, 1, 2, 0, 0, 1,
        1, 0, 0, 1, 1, 1, 1, 0, 0, 1, 1, 1, 1, 0, 0, 1,
        1, 0, 0, 1, 1, 1, 1, 6, 9, 1, 1, 1, 1, 0, 0, 1,
        1, 0, 0, 4, 1, 1, 1, 1, 1, 1, 1, 1, 3, 0, 0, 1,
        1, 6, 0, 0, 0, 0, 0, 0, 0, 0, 0, 0, 0, 0, 9, 1,
        1, 1, 6, 0, 0, 0, 0, 5, 2, 0, 0, 0, 0, 9, 1, 1,
        1, 1, 1, 6, 0, 0, 0, 4, 3, 0, 0, 0, 9, 1, 1, 1,
        1, 1, 1, 1, 6, 0, 0, 0, 0, 0, 0, 9, 1, 1, 1, 1,
        1, 1, 1, 1, 1, 6, 0, 0, 0, 0, 9, 1, 1, 1, 1, 1,
        1, 1, 1, 1, 1, 1, 1, 1, 1, 1, 1, 1, 1, 1, 1, 1
    ]
}